                                                                                               
              #####                                                                      ##### 
               ####                                                                       #### 
               ####                                                                       #### 
               ####                                                                       #### 
               ####                                                                       #### 
               ####                                                                       #### 
               ####                                                                       #### 
               ####                                                                       #### 
      ###      ####   ###         ###       #####   ###    #####   ###          ###       #### 
   ###   ##    #### #######     ##  ###      #### #######   #### #######     ###  ###     #### 
  ###     ###  #####    ####   ###   ####    #####    ####  #####    ####   ###     ###   #### 
 ###           ####     ####   ###    ###    ####     ####  ####     ####  ###      ####  #### 
 ###           ####     ####          ###    ####     ####  ####     ####  ###       ###  #### 
####           ####     ####     ##   ###    ####     ####  ####     #### ####       ###  #### 
####           ####     ####   ##########    ####     ####  ####     #### ##############  #### 
####           ####     ####  ###    ####    ####     ####  ####     #### ####            #### 
####           ####     #### ####     ###    ####     ####  ####     #### ####            #### 
 ###           ####     #### ####     ###    ####     ####  ####     ####  ###            #### 
  ###      ##  ####     ####  ###    ####    ####     ####  ####     ####   ###      ##   #### 
   ###    ##   ####     ####   ###########   ####     ####  ####     ####    ###    ##    #### 
      ###     ######    #####    ##    #### ######    ###########    #####      ###      ######
                                                                                               
